111111111
1010E0P01
1100C00E1
111111111