111111111111
1P0000000001
1000000C0001
1000000000E1
111111111111