111111111111111111111111111
1P000011110000000000000C001
1000000C0000000000000000001
100000000000001000001000001
100111000100000010000100101
100CC001110000000000000C001
1000000000000000C000E0000E1
111111111111111111111111111