1111111111111111
10000C00C00CE001
1P00C0000C000001
1E00CC0CC0000011
1111111111111111