111111111
100000001
1P00111C1
10000E001
100C00001
111111111