111111111
100000P01
100011101
10000E001
100C00001
111111111