1111111111111111111111111111
1P00000000000000000000000001
100C00CCCC00CCCC00CCCC000001
10CC00000C00000C00000C000001
100C00CCCC00CCCC00000C000001
100C00000C00000C00000C000001
10CCC0CCCC00CCCC00000C000001
10000000000000000000000000E1
1111111111111111111111111111