111111111
100010001
101P00001
1010C0101
110000E01
111111111