11111111111111111111111
10000CEP000001000000001
100C000000C001C0C0C0C01
100E000C000000000000001
11111111111111111111111