1111
10C1
1111
10E1
10P1
1111
1111
1111
1111